🌲🌲🌲🌲🌲🌲🌲🌲🌲🌲🌲🌲🌲🌲🌲
🌲                          🌲
🌲   ★●●●M●●●●?●            🌲
🌲   ●         ●            🌲
🌲   ●         ●            🌲
🌲   ?         M            🌲
🌲   ●         ●            🌲
🌲   ●         ●            🌲
🌲   ●●●●M●●●●●●            🌲
🌲                          🌲
🌲🌲🌲🌲🌲🌲🌲🌲🌲🌲🌲🌲🌲🌲🌲
